Fault No.,No.,Z (ms) HW,Z (ms) FW,CDP HW,CDP FW,Z (ms) Diff,CDP Diff,Heave (m),Throw (m),Displacement (m)
1,1,2826,2836,1430,1424,10,6,75,25,79.1
1,2,2890,2908,1420,1414,18,6,75,45,87.5
1,3,2957,2980,1414,1406,23,8,100,57.5,115.4
1,4,2997,3005,1406,1400,8,6,75,20,77.6
1,5,3005,3043,1402,1396,38,6,75,95,121.0
1,6,3048,3087,1398,1390,39,8,100,97.5,139.7
1,7,3069,3120,1394,1386,51,8,100,127.5,162.0
1,8,3144,3191,1384,1380,47,4,50,117.5,127.7
1,9,3186,3229,1386,1368,43,18,225,107.5,249.4
1,10,3343,3418,1360,1346,75,14,175,187.5,256.5
1,11,3459,3570,1344,1326,111,18,225,277.5,357.3
1,12,3562,3674,1330,1310,112,20,250,280,375.4
1,13,3652,3763,1332,1298,111,34,425,277.5,507.6
1,14,3741,3840,1308,1286,99,22,275,247.5,370.0
1,15,3839,3937,1298,1260,98,38,475,245,534.5
1,16,3870,3967,1286,1260,97,26,325,242.5,405.5
2,1,3294,3301,2908,2906,7,2,25,17.5,30.5
2,2,3342,3369,2902,2894,27,8,100,67.5,120.6
2,3,3355,3385,2898,2894,30,4,50,75,90.1
2,4,3424,3452,2892,2884,28,8,100,70,122.1
2,5,3518,3533,2888,2874,15,14,175,37.5,179.0
2,6,3539,3550,2882,2874,11,8,100,27.5,103.7
2,7,3616,3645,2868,2858,29,10,125,72.5,144.5
2,8,3651,3687,2864,2856,36,8,100,90,134.5
2,9,3674,3706,2862,2852,32,10,125,80,148.4
2,10,3749,3778,2854,2844,29,10,125,72.5,144.5
2,11,3904,3944,2826,2816,40,10,125,100,160.1
2,12,4056,4108,2808,2796,52,12,150,130,198.5
2,13,4158,4196,2788,2778,38,10,125,95,157.0
2,14,4290,4326,2772,2760,36,12,150,90,174.9
2,15,4418,4446,2748,2742,28,6,75,70,102.6
2,16,4852,4868,2644,2640,16,4,50,40,64.0
3,1,3186,3211,2434,2426,25,8,100,62.5,117.9
3,2,3210,3227,2430,2428,17,2,25,42.5,49.3
3,3,3292,3312,2412,2406,20,6,75,50,90.1
3,4,3330,3364,2402,2392,34,10,125,85,151.2
3,5,3422,3441,2402,2396,19,6,75,47.5,88.8
3,6,3444,3456,2400,2394,12,6,75,30,80.8
3,7,3486,3505,2394,2390,19,4,50,47.5,69.0
3,8,3506,3524,2396,2388,18,8,100,45,109.7
3,9,3594,3626,2402,2388,32,14,175,80,192.4
3,10,3694,3740,2382,2366,46,16,200,115,230.7
3,11,3794,3824,2368,2362,30,6,75,75,106.1
3,12,3886,3916,2358,2350,30,8,100,75,125.0
3,13,4011,4040,2340,2330,29,10,125,72.5,144.5
3,14,4120,4143,2322,2312,23,10,125,57.5,137.6
3,15,4374,4396,2274,2260,22,14,175,55,183.4
3,16,4702,4720,2174,2164,18,10,125,45,132.9
4,1,3274,3294,2774,2768,20,6,75,50,90.1
4,2,3296,3316,2770,2764,20,6,75,50,90.1
4,3,3355,3377,2766,2756,22,10,125,55,136.6
4,4,3493,3520,2752,2740,27,12,150,67.5,164.5
4,5,3547,3576,2746,2736,29,10,125,72.5,144.5
4,6,3624,3656,2738,2726,32,12,150,80,170.0
4,7,3694,3721,2738,2720,27,18,225,67.5,234.9
4,8,3903,3945,2700,2690,42,10,125,105,163.2
4,9,4092,4123,2676,2664,31,12,150,77.5,168.8
4,10,4242,4287,2650,2636,45,14,175,112.5,208.0
4,11,4311,4354,2646,2630,43,16,200,107.5,227.1
4,12,4482,4523,2608,2594,41,14,175,102.5,202.8
4,13,4667,4692,2566,2546,25,20,250,62.5,257.7
4,14,4747,4770,2548,2530,23,18,225,57.5,232.2
4,15,4873,4907,2514,2502,34,12,150,85,172.4
4,16,4928,4947,2490,2482,19,8,100,47.5,110.7
5,1,3214,3226,2774,2768,12,6,75,30,80.8
5,2,3266,3278,2766,2760,12,6,75,30,80.8
5,3,3294,3311,2766,2760,17,6,75,42.5,86.2
5,4,3330,3350,2764,2756,20,8,100,50,111.8
5,5,3517,3544,2738,2730,27,8,100,67.5,120.6
5,6,3623,3649,2724,2716,26,8,100,65,119.3
5,7,3744,3778,2710,2698,34,12,150,85,172.4
5,8,3877,3913,2694,2692,36,2,25,90,93.4
5,9,4092,4122,2674,2658,30,16,200,75,213.6
5,10,4172,4216,2662,2648,44,14,175,110,206.7
5,11,4262,4310,2646,2632,48,14,175,120,212.2
5,12,4370,4420,2628,2614,50,14,175,125,215.1
5,13,4532,4580,2592,2580,48,12,150,120,192.1
5,14,4632,4660,2572,2554,28,18,225,70,235.6
5,15,4706,4734,2558,2544,28,14,175,70,188.5
5,16,4902,4930,2498,2482,28,16,200,70,211.9
6,1,2988,2996,2794,2792,8,2,25,20,32.0
6,2,3010,3016,2794,2790,6,4,50,15,52.2
6,3,3107,3116,2784,2780,9,4,50,22.5,54.8
6,4,3233,3250,2774,2754,17,20,250,42.5,253.6
6,5,3276,3288,2756,2750,12,6,75,30,80.8
6,6,3352,3383,2750,2742,31,8,100,77.5,126.5
6,7,3497,3521,2732,2728,24,4,50,60,78.1
6,8,3543,3569,2730,2720,26,10,125,65,140.9
6,9,3625,3650,2720,2714,25,6,75,62.5,97.6
6,10,3852,3900,2696,2682,48,14,175,120,212.2
6,11,3898,3940,2682,2672,42,10,125,105,163.2
6,12,4082,4118,2660,2650,36,10,125,90,154.0
6,13,4264,4290,2632,2616,26,16,200,65,210.3
6,14,4520,4556,2588,2572,36,16,200,90,219.3
6,15,4622,4656,4622,2552,34,2070,25875,85,25875.1
6,16,4906,4932,2490,2480,26,10,125,65,140.9
7,1,3044,3056,2612,2610,12,2,25,30,39.1
7,2,3098,3112,2608,2604,14,4,50,35,61.0
7,3,3140,3160,2608,2600,20,8,100,50,111.8
7,4,3228,3264,2598,2592,36,6,75,90,117.2
7,5,3310,3342,2590,2580,32,10,125,80,148.4
7,6,3366,3394,2584,2576,28,8,100,70,122.1
7,7,3452,3490,2580,2569,38,11,137.5,95,167.1
7,8,3502,3542,2572,2562,40,10,125,100,160.1
7,9,3572,3628,2560,2550,56,10,125,140,187.7
7,10,3728,3766,2546,2530,38,16,200,95,221.4
7,11,3856,3882,2522,2510,26,12,150,65,163.5
7,12,3958,3978,2512,2502,20,10,125,50,134.6
7,13,3994,4016,2506,2496,22,10,125,55,136.6
7,14,4114,4136,2484,2472,22,12,150,55,159.8
7,15,4216,4242,2454,2446,26,8,100,65,119.3
7,16,4560,4574,2418,2410,14,8,100,35,105.9
8,1,2865,2870,2194,2192,5,2,25,12.5,28.0
8,2,2981,2988,2188,2180,7,8,100,17.5,101.5
8,3,3145,3166,2172,2170,21,2,25,52.5,58.1
8,4,3159,3183,2176,2168,24,8,100,60,116.6
8,5,3275,3304,2158,2150,29,8,100,72.5,123.5
8,6,3412,3443,2136,2130,31,6,75,77.5,107.8
8,7,3430,3445,2138,2130,15,8,100,37.5,106.8
8,8,3464,3480,2132,2126,16,6,75,40,85.0
8,9,3526,3551,2124,2104,25,20,250,62.5,257.7
8,10,3623,3653,2104,2086,30,18,225,75,237.2
8,11,3685,3736,2098,2086,51,12,150,127.5,196.9
8,12,3809,3860,2086,2068,51,18,225,127.5,258.6
8,13,3932,3964,2066,2046,32,20,250,80,262.5
8,14,4124,4156,2020,2006,32,14,175,80,192.4
8,15,4270,4301,1990,1972,31,18,225,77.5,238.0
8,16,4550,4570,1944,1928,20,16,200,50,206.2
9,1,3053,3059,2112,2108,6,4,50,15,52.2
9,2,3121,3128,2110,2106,7,4,50,17.5,53.0
9,3,3194,3224,2102,2094,30,8,100,75,125.0
9,4,3241,3279,2096,2088,38,8,100,95,137.9
9,5,3308,3350,2092,2084,42,8,100,105,145.0
9,6,3359,3394,2084,2076,35,8,100,87.5,132.9
9,7,3403,3435,2080,2070,32,10,125,80,148.4
9,8,3522,3536,2072,2064,14,8,100,35,105.9
9,9,3610,3632,2054,2048,22,6,75,55,93.0
9,10,3648,3678,2048,2040,30,8,100,75,125.0
9,11,3780,3816,2036,2024,36,12,150,90,174.9
9,12,3902,3972,2018,2008,70,10,125,175,215.1
9,13,4026,4080,2002,1984,54,18,225,135,262.4
9,14,4260,4308,1954,1940,48,14,175,120,212.2
9,15,4310,4352,1948,1932,42,16,200,105,225.9
9,16,4800,4840,1856,1842,40,14,175,100,201.6
10,1,2894,2904,2646,2642,10,4,50,25,55.9
10,2,2907,2924,2644,2636,17,8,100,42.5,108.7
10,3,3047,3056,2628,2626,9,2,25,22.5,33.6
10,4,3244,3273,2608,2604,29,4,50,72.5,88.1
10,5,3307,3342,2602,2590,35,12,150,87.5,173.7
10,6,3514,3561,2582,2568,47,14,175,117.5,210.8
10,7,3540,3580,2580,2568,40,12,150,100,180.3
10,8,3580,3617,2572,2562,37,10,125,92.5,155.5
10,9,3864,3882,2534,2530,18,4,50,45,67.3
10,10,4130,4146,2504,2494,16,10,125,40,131.2
10,11,4224,4244,2486,2476,20,10,125,50,134.6
10,12,4480,4536,2486,2472,56,14,175,140,224.1
10,13,4594,4636,2466,2446,42,20,250,105,271.2
10,14,4706,4746,2436,2426,40,10,125,100,160.1
10,15,4766,4800,2420,2414,34,6,75,85,113.4
10,16,4908,4938,2366,2366,30,0,0,75,75.0
11,1,2888,2900,2682,2676,12,6,75,30,80.8
11,2,2910,2926,2678,2674,16,4,50,40,64.0
11,3,2958,2972,2676,2672,14,4,50,35,61.0
11,4,3006,3016,2674,2668,10,6,75,25,79.1
11,5,3242,3270,2652,2642,28,10,125,70,143.3
11,6,3260,3294,2648,2642,34,6,75,85,113.4
11,7,3354,3376,2640,2630,22,10,125,55,136.6
11,8,3420,3448,2630,2622,28,8,100,70,122.1
11,9,3500,3528,2620,2614,28,6,75,70,102.6
11,10,3602,3638,2610,2602,36,8,100,90,134.5
11,11,3752,3802,2596,2568,50,28,350,125,371.7
11,12,3884,3930,2574,2554,46,20,250,115,275.2
11,13,4212,4240,2532,2520,28,12,150,70,165.5
11,14,4606,4638,2474,2452,32,22,275,80,286.4
11,15,4756,4792,2436,2418,36,18,225,90,242.3
11,16,4834,4856,2410,2390,22,20,250,55,256.0
12,1,3378,3396,2062,2068,18,6,75,45,87.5
12,2,3394,3420,2062,2066,26,4,50,65,82.0
12,3,3414,3450,2062,2070,36,8,100,90,134.5
12,4,3488,3522,2066,2074,34,8,100,85,131.2
12,5,3566,3596,2068,2080,30,12,150,75,167.7
12,6,3660,3690,2070,2078,30,8,100,75,125.0
12,7,3736,3758,2084,2098,22,14,175,55,183.4
12,8,3864,3902,2098,2108,38,10,125,95,157.0
12,9,4012,4078,2116,2130,66,14,175,165,240.5
12,10,4110,4160,2132,2144,50,12,150,125,195.3
12,11,4290,4366,2156,2176,76,20,250,190,314.0
12,12,4390,4474,2170,2200,84,30,375,210,429.8
12,13,4532,4608,2184,2218,76,34,425,190,465.5
12,14,4638,4690,2228,2250,52,22,275,130,304.2
12,15,4804,4846,2266,2280,42,14,175,105,204.1
12,16,4886,4920,2274,2286,34,12,150,85,172.4
13,1,2714,2723,2224,2220,9,4,50,22.5,54.8
13,2,2740,2754,2222,2218,14,4,50,35,61.0
13,3,2940,2964,2212,2208,24,4,50,60,78.1
13,4,3181,3208,2194,2188,27,6,75,67.5,100.9
13,5,3230,3262,2188,2180,32,8,100,80,128.1
13,6,3308,3343,2180,2174,35,6,75,87.5,115.2
13,7,3426,3451,2168,2158,25,10,125,62.5,139.8
13,8,3476,3493,2162,2158,17,4,50,42.5,65.6
13,9,3593,3617,2146,2136,24,10,125,60,138.7
13,10,3763,3778,2122,2116,15,6,75,37.5,83.9
13,11,3922,3952,2116,2108,30,8,100,75,125.0
13,12,4098,4156,2092,2074,58,18,225,145,267.7
13,13,4194,4240,2080,2064,46,16,200,115,230.7
13,14,4332,4378,2052,2040,46,12,150,115,189.0
13,15,4482,4516,2026,2008,34,18,225,85,240.5
13,16,4650,4672,1976,1966,22,10,125,55,136.6
14,1,3402,3412,3272,3266,10,6,75,25,79.1
14,2,3452,3458,3264,3260,6,4,50,15,52.2
14,3,3530,3550,3256,3252,20,4,50,50,70.7
14,4,3614,3632,3248,3242,18,6,75,45,87.5
14,5,3640,3662,3240,3234,22,6,75,55,93.0
14,6,3734,3758,3232,3226,24,6,75,60,96.0
14,7,3848,3872,3218,3204,24,14,175,60,185.0
14,8,3994,4014,3196,3190,20,6,75,50,90.1
14,9,4076,4100,3192,3180,24,12,150,60,161.6
14,10,4142,4162,3174,3166,20,8,100,50,111.8
14,11,4338,4394,3144,3122,56,22,275,140,308.6
14,12,4404,4464,3130,3114,60,16,200,150,250.0
14,13,4488,4540,3116,3094,52,22,275,130,304.2
14,14,4566,4604,3104,3086,38,18,225,95,244.2
14,15,4682,4718,3076,3060,36,16,200,90,219.3
14,16,4772,4806,3056,3042,34,14,175,85,194.6
15,1,2734,2746,2230,2224,12,6,75,30,80.8
15,2,2994,3004,2212,2208,10,4,50,25,55.9
15,3,3112,3144,2200,2196,32,4,50,80,94.3
15,4,3258,3278,2192,2184,20,8,100,50,111.8
15,5,3386,3418,2176,2170,32,6,75,80,109.7
15,6,3454,3476,2166,2160,22,6,75,55,93.0
15,7,3520,3544,2156,2144,24,12,150,60,161.6
15,8,3932,3968,2126,2116,36,10,125,90,154.0
15,9,4184,4230,2090,2072,46,18,225,115,252.7
15,10,4292,4340,2064,2052,48,12,150,120,192.1
15,11,4462,4506,2026,2016,44,10,125,110,166.5
15,12,4594,4634,1994,1980,40,14,175,100,201.6
15,13,4646,4676,1984,1970,30,14,175,75,190.4
15,14,4670,4702,1982,1968,32,14,175,80,192.4
15,15,4690,4726,1978,1964,36,14,175,90,196.8
15,16,4806,4818,1928,1908,12,20,250,30,251.8
16,1,3174,3187,2504,2502,13,2,25,32.5,41.0
16,2,3217,3248,2500,2496,31,4,50,77.5,92.2
16,3,3301,3334,2494,2484,33,10,125,82.5,149.8
16,4,3416,3426,2478,2474,10,4,50,25,55.9
16,5,3476,3499,2472,2466,23,6,75,57.5,94.5
16,6,3733,3744,2402,2392,11,10,125,27.5,128.0
16,7,3794,3815,2396,2390,21,6,75,52.5,91.5
16,8,3891,3914,2390,2384,23,6,75,57.5,94.5
16,9,3966,3994,2382,2370,28,12,150,70,165.5
16,10,4024,4038,2372,2362,14,10,125,35,129.8
16,11,4130,4148,2358,2338,18,20,250,45,254.0
16,12,4200,4244,2340,2326,44,14,175,110,206.7
16,13,4300,4336,2322,2306,36,16,200,90,219.3
16,14,4376,4410,2310,2296,34,14,175,85,194.6
16,15,4460,4478,2288,2280,18,8,100,45,109.7
16,16,4652,4676,2230,2220,24,10,125,60,138.7
17,1,3284,3302,2358,2362,18,4,50,45,67.3
17,2,3322,3338,2358,2364,16,6,75,40,85.0
17,3,3420,3432,2370,2374,12,4,50,30,58.3
17,4,3518,3550,2372,2376,32,4,50,80,94.3
17,5,3636,3664,2380,2386,28,6,75,70,102.6
17,6,3738,3776,2394,2400,38,6,75,95,121.0
17,7,3765,3805,2396,2400,40,4,50,100,111.8
17,8,3847,3871,2398,2410,24,12,150,60,161.6
17,9,3910,3931,2400,2412,21,12,150,52.5,158.9
17,10,3971,3986,2410,2420,15,10,125,37.5,130.5
17,11,4165,4211,2436,2452,46,16,200,115,230.7
17,12,4183,4242,2432,2442,59,10,125,147.5,193.3
17,13,4356,4387,2458,2474,31,16,200,77.5,214.5
17,14,4459,4489,2476,2480,30,4,50,75,90.1
17,15,4544,4565,2490,2496,21,6,75,52.5,91.5
17,16,4654,4670,2510,2520,16,10,125,40,131.2
18,1,3361,3369,2554,2550,8,4,50,20,53.9
18,2,3382,3391,2552,2548,9,4,50,22.5,54.8
18,3,3413,3444,2546,2536,31,10,125,77.5,147.1
18,4,3468,3504,2540,2530,36,10,125,90,154.0
18,5,3494,3528,2536,2526,34,10,125,85,151.2
18,6,3537,3564,2530,2522,27,8,100,67.5,120.6
18,7,3579,3605,2524,2512,26,12,150,65,163.5
18,8,3630,3654,2516,2506,24,10,125,60,138.7
18,9,3684,3703,2502,2492,19,10,125,47.5,133.7
18,10,3737,3751,2488,2482,14,6,75,35,82.8
18,11,3797,3809,2478,2472,12,6,75,30,80.8
18,12,3834,3855,2470,2466,21,4,50,52.5,72.5
18,13,4198,4232,2412,2396,34,16,200,85,217.3
18,14,4246,4288,2392,2378,42,14,175,105,204.1
18,15,4366,4386,2370,2364,20,6,75,50,90.1
18,16,4492,4500,2350,2346,8,4,50,20,53.9
19,1,2926,2946,2208,2202,20,6,75,50,90.1
19,2,3000,3024,2204,2198,24,6,75,60,96.0
19,3,3059,3079,2200,2194,20,6,75,50,90.1
19,4,3099,3117,2196,2192,18,4,50,45,67.3
19,5,3159,3171,2190,2186,12,4,50,30,58.3
19,6,3322,3342,2180,2172,20,8,100,50,111.8
19,7,3438,3470,2164,2152,32,12,150,80,170.0
19,8,3493,3508,2156,2148,15,8,100,37.5,106.8
19,9,3738,3756,2128,2120,18,8,100,45,109.7
19,10,3766,3780,2130,2118,14,12,150,35,154.0
19,11,3930,3952,2114,2110,22,4,50,55,74.3
19,12,4034,4058,2096,2088,24,8,100,60,116.6
19,13,4086,4116,2094,2086,30,8,100,75,125.0
19,14,4176,4222,2078,2062,46,16,200,115,230.7
19,15,4338,4378,2048,2036,40,12,150,100,180.3
19,16,4476,4504,2022,2016,28,6,75,70,102.6
20,1,2930,2946,2746,2742,16,4,50,40,64.0
20,2,2992,3014,2742,2736,22,6,75,55,93.0
20,3,3080,3100,2738,2730,20,8,100,50,111.8
20,4,3132,3150,2730,2724,18,6,75,45,87.5
20,5,3262,3292,2720,2714,30,6,75,75,106.1
20,6,3342,3366,2710,2702,24,8,100,60,116.6
20,7,3410,3432,2702,2696,22,6,75,55,93.0
20,8,3510,3522,2694,2686,12,8,100,30,104.4
20,9,3760,3776,2652,2648,16,4,50,40,64.0
20,10,3874,3900,2642,2634,26,8,100,65,119.3
20,11,3906,3928,2640,2632,22,8,100,55,114.1
20,12,4056,4086,2618,2610,30,8,100,75,125.0
20,13,4234,4272,2594,2582,38,12,150,95,177.6
20,14,4440,4480,2558,2540,40,18,225,100,246.2
20,15,4600,4632,2524,2512,32,12,150,80,170.0
20,16,4796,4816,2492,2478,20,14,175,50,182.0
21,1,2956,2972,2100,2096,16,4,50,40,64.0
21,2,3046,3060,2092,2090,14,2,25,35,43.0
21,3,3104,3124,2094,2084,20,10,125,50,134.6
21,4,3210,3242,2078,2074,32,4,50,80,94.3
21,5,3340,3358,2062,2056,18,6,75,45,87.5
21,6,3404,3420,2050,2046,16,4,50,40,64.0
21,7,3484,3502,2044,2038,18,6,75,45,87.5
21,8,3632,3658,2024,2012,26,12,150,65,163.5
21,9,3708,3740,2010,2008,32,2,25,80,83.8
21,10,3906,3938,1988,1974,32,14,175,80,192.4
21,11,3980,4020,1976,1966,40,10,125,100,160.1
21,12,4026,4084,1966,1956,58,10,125,145,191.4
21,13,4264,4318,1924,1906,54,18,225,135,262.4
21,14,4408,4460,1900,1888,52,12,150,130,198.5
21,15,4670,4698,1858,1850,28,8,100,70,122.1
21,16,4782,4814,1846,1836,32,10,125,80,148.4
22,1,3336,3352,3276,3272,16,4,50,40,64.0
22,2,3376,3388,3272,3268,12,4,50,30,58.3
22,3,3426,3440,3272,3264,14,8,100,35,105.9
22,4,3474,3494,3268,3260,20,8,100,50,111.8
22,5,3524,3548,3262,3264,24,-2,-25,60,65.0
22,6,3654,3680,3246,3240,26,6,75,65,99.2
22,7,3736,3758,3234,3228,22,6,75,55,93.0
22,8,3912,3940,3214,3208,28,6,75,70,102.6
22,9,3982,4022,3202,3190,40,12,150,100,180.3
22,10,4062,4098,3198,3176,36,22,275,90,289.4
22,11,4204,4238,3168,3156,34,12,150,85,172.4
22,12,4494,4524,3110,3100,30,10,125,75,145.8
22,13,4572,4598,3098,3086,26,12,150,65,163.5
22,14,4632,4654,3084,3080,22,4,50,55,74.3
22,15,4684,4700,3072,3068,16,4,50,40,64.0
22,16,4766,4784,3066,3060,18,6,75,45,87.5
23,1,2866,2882,2162,2156,16,6,75,40,85.0
23,2,3006,3014,2142,2138,8,4,50,20,53.9
23,3,3088,3106,2136,2132,18,4,50,45,67.3
23,4,3278,3292,2116,2108,14,8,100,35,105.9
23,5,3328,3366,2096,2088,38,8,100,95,137.9
23,6,3420,3460,2082,2074,40,8,100,100,141.4
23,7,3654,3704,2058,2046,50,12,150,125,195.3
23,8,3766,3818,2046,2028,52,18,225,130,259.9
23,9,3924,3942,2018,2010,18,8,100,45,109.7
23,10,4008,4078,2008,1990,70,18,225,175,285.0
23,11,4126,4192,1988,1970,66,18,225,165,279.0
23,12,4266,4328,1962,1936,62,26,325,155,360.1
23,13,4328,4370,1948,1932,42,16,200,105,225.9
23,14,4448,4488,1922,1914,40,8,100,100,141.4
23,15,4544,4572,1908,1898,28,10,125,70,143.3
23,16,4608,4630,1900,1892,22,8,100,55,114.1
24,1,3292,3314,2762,2756,22,6,75,55,93.0
24,2,3354,3386,2752,2744,32,8,100,80,128.1
24,3,3412,3446,2748,2738,34,10,125,85,151.2
24,4,3502,3534,2734,2728,32,6,75,80,109.7
24,5,3612,3642,2722,2714,30,8,100,75,125.0
24,6,3720,3746,2714,2708,26,6,75,65,99.2
24,7,3898,3934,2694,2682,36,12,150,90,174.9
24,8,4084,4128,2668,2656,44,12,150,110,186.0
24,9,4258,4312,2636,2626,54,10,125,135,184.0
24,10,4394,4440,2620,2612,46,8,100,115,152.4
24,11,4478,4516,2604,2592,38,12,150,95,177.6
24,12,4630,4658,2568,2558,28,10,125,70,143.3
24,13,4694,4714,2552,2540,20,12,150,50,158.1
24,14,4730,4756,2540,2522,26,18,225,65,234.2
24,15,4762,4782,2518,2512,20,6,75,50,90.1
24,16,4866,4886,2504,2498,20,6,75,50,90.1
25,1,2934,2940,2738,2732,6,6,75,15,76.5
25,2,3252,3268,2716,2708,16,8,100,40,107.7
25,3,3338,3362,2706,2700,24,6,75,60,96.0
25,4,3476,3494,2696,2690,18,6,75,45,87.5
25,5,3636,3650,2676,2674,14,2,25,35,43.0
25,6,3896,3930,2638,2628,34,10,125,85,151.2
25,7,4086,4128,2616,2604,42,12,150,105,183.1
25,8,4178,4210,2602,2590,32,12,150,80,170.0
25,9,4240,4270,2592,2582,30,10,125,75,145.8
25,10,4320,4346,2578,2566,26,12,150,65,163.5
25,11,4464,4492,2558,2542,28,16,200,70,211.9
25,12,4588,4612,2526,2514,24,12,150,60,161.6
25,13,4714,4742,2502,2490,28,12,150,70,165.5
25,14,4786,4804,2492,2480,18,12,150,45,156.6
25,15,4836,4844,2482,2472,8,10,125,20,126.6
25,16,4866,4884,2468,2460,18,8,100,45,109.7